"a" = (/obj/structure/sign/departments/science,/turf/closed/wall/mineral/titanium/survival/pod,/area/survivalpod)
"b" = (/turf/closed/wall/mineral/titanium/survival/pod,/area/survivalpod)
"c" = (/obj/effect/spawner/structure/window/reinforced,/obj/machinery/door/poddoor/shutters/preopen{id = "rndlab1"; name = "Research and Development Shutter"},/turf/open/floor/plating,/area/survivalpod)
"d" = (/obj/machinery/door/poddoor/shutters/preopen{id = "rndlab1"; name = "Research and Development Shutter"},/obj/effect/spawner/structure/window/reinforced,/turf/open/floor/plating,/area/survivalpod)
"e" = (/obj/structure/sign/nanotrasen,/turf/closed/wall/mineral/titanium/survival/pod,/area/survivalpod)
"f" = (/obj/structure/sign/warning/nosmoking,/turf/closed/wall/mineral/titanium/survival/pod,/area/survivalpod)
"g" = (/obj/structure/table,/obj/item/stack/sheet/metal/fifty,/obj/item/stack/sheet/glass/fifty,/obj/item/wrench,/obj/item/clothing/glasses/welding,/obj/machinery/newscaster{pixel_y = 32},/obj/effect/turf_decal/tile/purple{dir = 4},/turf/open/floor/plasteel,/area/survivalpod)
"h" = (/obj/structure/table/reinforced,/obj/machinery/light{dir = 1},/obj/machinery/cell_charger,/obj/effect/turf_decal/stripes/line{dir = 9},/turf/open/floor/plasteel/white,/area/survivalpod)
"i" = (/obj/item/radio/intercom{pixel_y = 28},/obj/machinery/computer/rdservercontrol{dir = 2},/obj/machinery/camera{c_tag = "Research Division - Server Room"; dir = 2; network = list("ss13","rd"); pixel_x = 22},/turf/open/floor/plasteel/dark,/area/survivalpod)
"j" = (/obj/machinery/atmospherics/components/unary/thermomachine/freezer/on,/obj/effect/decal/cleanable/cobweb/cobweb2,/turf/open/floor/plasteel/dark,/area/survivalpod)
"k" = (/obj/effect/spawner/structure/window/reinforced,/obj/structure/sign/warning/securearea{desc = "A warning sign which reads 'SERVER ROOM'."; name = "SERVER ROOM"; pixel_y = 32},/turf/open/floor/plating,/area/survivalpod)
"l" = (/obj/machinery/rnd/server,/turf/open/floor/circuit/telecomms/server,/area/survivalpod)
"m" = (/obj/machinery/atmospherics/components/unary/vent_pump/on{external_pressure_bound = 140; name = "server vent"; pressure_checks = 0},/turf/open/floor/circuit/telecomms/server,/area/survivalpod)
"n" = (/obj/structure/table/reinforced,/obj/item/stack/cable_coil/white{pixel_x = 3; pixel_y = 3},/obj/item/stack/cable_coil/white,/obj/item/stock_parts/scanning_module{pixel_x = 3; pixel_y = 3},/obj/item/stock_parts/capacitor,/obj/item/stock_parts/manipulator,/obj/item/stock_parts/manipulator,/obj/effect/turf_decal/stripes/line{dir = 4},/turf/open/floor/plasteel,/area/survivalpod)
"o" = (/turf/open/floor/plasteel,/area/survivalpod)
"p" = (/obj/structure/chair/office/light,/turf/open/floor/plasteel/dark,/area/survivalpod)
"q" = (/obj/machinery/atmospherics/pipe/simple{dir = 5},/turf/open/floor/plasteel/dark,/area/survivalpod)
"r" = (/obj/machinery/door/firedoor,/obj/machinery/door/airlock/command/glass{name = "Server Access"; req_access_txt = "30"},/obj/machinery/atmospherics/pipe/simple{dir = 4},/turf/open/floor/plasteel/dark,/area/survivalpod)
"s" = (/obj/machinery/atmospherics/pipe/simple{dir = 4},/turf/open/floor/plasteel/dark/telecomms,/area/survivalpod)
"t" = (/obj/machinery/atmospherics/pipe/manifold{dir = 4},/obj/machinery/light/small{dir = 4},/obj/machinery/airalarm/server{dir = 8; pixel_x = 22},/turf/open/floor/plasteel/dark/telecomms,/area/survivalpod)
"u" = (/obj/structure/table/reinforced,/obj/item/stock_parts/matter_bin{pixel_x = 3; pixel_y = 3},/obj/item/stock_parts/matter_bin,/obj/item/stock_parts/micro_laser,/obj/effect/turf_decal/stripes/line{dir = 4},/turf/open/floor/plasteel,/area/survivalpod)
"v" = (/turf/open/floor/plasteel/dark,/area/survivalpod)
"w" = (/obj/structure/table,/obj/item/folder/white{pixel_x = 4; pixel_y = -3},/obj/item/pen,/turf/open/floor/plasteel/dark,/area/survivalpod)
"x" = (/obj/effect/spawner/structure/window/reinforced,/turf/open/floor/plating,/area/survivalpod)
"y" = (/obj/machinery/atmospherics/components/unary/vent_pump/siphon/on{dir = 1; external_pressure_bound = 120; name = "server vent"},/turf/open/floor/circuit/telecomms/server,/area/survivalpod)
"z" = (/obj/machinery/rnd/destructive_analyzer,/obj/effect/turf_decal/stripes/line{dir = 9},/obj/machinery/status_display/ai{pixel_x = -32},/turf/open/floor/plasteel,/area/survivalpod)
"A" = (/turf/open/floor/plasteel/white,/area/survivalpod)
"B" = (/obj/effect/turf_decal/tile/purple,/obj/effect/turf_decal/tile/purple{dir = 4},/turf/open/floor/plasteel/white,/area/survivalpod)
"C" = (/obj/machinery/requests_console{department = "Research Lab"; name = "Research RC"; pixel_x = 32; receive_ore_updates = 1},/turf/closed/wall/mineral/titanium/survival/pod,/area/survivalpod)
"D" = (/obj/machinery/computer/rdconsole/core{dir = 4},/obj/effect/turf_decal/stripes/line{dir = 10},/turf/open/floor/plasteel/white,/area/survivalpod)
"E" = (/obj/machinery/light{dir = 1},/obj/item/twohanded/required/kirbyplants/random,/obj/machinery/status_display/evac{pixel_y = 32},/obj/effect/turf_decal/tile/purple{dir = 1},/turf/open/floor/plasteel,/area/survivalpod)
"F" = (/obj/item/twohanded/required/kirbyplants/random,/obj/effect/turf_decal/tile/purple,/turf/open/floor/plasteel/white,/area/survivalpod)
"G" = (/obj/effect/spawner/structure/window/reinforced,/obj/machinery/door/poddoor/shutters/preopen{id = "rndlab2"; name = "Secondary Research and Development Shutter"},/turf/open/floor/plating,/area/survivalpod)
"H" = (/obj/machinery/light{dir = 8},/obj/effect/turf_decal/stripes/line{dir = 5},/obj/machinery/rnd/production/protolathe/department/science,/turf/open/floor/plasteel,/area/survivalpod)
"I" = (/obj/structure/table/reinforced,/obj/item/stack/packageWrap,/obj/item/hand_labeler,/obj/effect/turf_decal/stripes/line{dir = 1},/turf/open/floor/plasteel,/area/survivalpod)
"J" = (/obj/effect/turf_decal/tile/neutral{dir = 1},/obj/effect/turf_decal/tile/neutral,/obj/effect/turf_decal/tile/neutral{dir = 4},/obj/effect/turf_decal/tile/neutral{dir = 8},/turf/open/floor/plasteel,/area/survivalpod)
"K" = (/obj/structure/chair/office/light{dir = 4},/obj/effect/turf_decal/tile/purple,/turf/open/floor/plasteel/white,/area/survivalpod)
"L" = (/obj/structure/table/reinforced,/obj/machinery/door/firedoor,/obj/item/folder,/obj/item/pen,/obj/machinery/door/window/southleft{dir = 8; name = "Research Lab Desk"; req_one_access_txt = "7;29"},/obj/machinery/door/poddoor/shutters/preopen{id = "rndlab2"; name = "Secondary Research and Development Shutter"},/obj/machinery/door/window/eastright,/obj/effect/turf_decal/delivery,/obj/structure/fans/tiny,/turf/open/floor/plasteel,/area/survivalpod)
"M" = (/obj/effect/spawner/structure/window/reinforced,/obj/machinery/door/poddoor/shutters/preopen{id = "rdrnd"; name = "Research and Development Shutters"},/turf/open/floor/plating,/area/survivalpod)
"N" = (/obj/effect/turf_decal/stripes/line{dir = 6},/obj/machinery/rnd/production/circuit_imprinter/department/science,/turf/open/floor/plasteel/white,/area/survivalpod)
"O" = (/obj/structure/table,/obj/item/disk/tech_disk{pixel_x = -6},/obj/item/disk/tech_disk{pixel_x = 6},/obj/item/disk/tech_disk{pixel_y = 6},/obj/effect/turf_decal/tile/purple,/obj/effect/turf_decal/tile/purple{dir = 4},/obj/effect/turf_decal/tile/purple{dir = 8},/obj/machinery/camera{c_tag = "Research Division - Server Room"; dir = 1; network = list("ss13","rd"); pixel_x = 22},/turf/open/floor/plasteel,/area/survivalpod)
"P" = (/obj/effect/turf_decal/tile/purple,/turf/open/floor/plasteel/white,/area/survivalpod)
"Q" = (/obj/structure/table/reinforced,/obj/item/folder/white,/obj/item/reagent_containers/glass/beaker/large,/obj/item/reagent_containers/glass/beaker,/obj/item/reagent_containers/dropper,/obj/structure/extinguisher_cabinet{pixel_y = -32},/obj/effect/turf_decal/stripes/line{dir = 9},/turf/open/floor/plasteel,/area/survivalpod)
"R" = (/obj/structure/table/reinforced,/obj/machinery/light,/obj/item/paper_bin,/obj/item/pen,/obj/machinery/button/door{id = "rndlab1"; name = "Primary Research Shutters Control"; pixel_x = -7; pixel_y = -23; req_access_txt = "7"},/obj/machinery/button/door{id = "rndlab2"; name = "Secondary Research Shutters Control"; pixel_x = 7; pixel_y = -23; req_access_txt = "7"},/obj/effect/turf_decal/stripes/line{dir = 5},/turf/open/floor/plasteel,/area/survivalpod)
"S" = (/obj/structure/table/reinforced,/obj/item/storage/toolbox/mechanical{pixel_x = -3; pixel_y = 3},/obj/item/storage/toolbox/mechanical,/obj/item/stack/cable_coil/white,/obj/item/stack/cable_coil/white,/obj/machinery/status_display/evac{pixel_y = -32},/obj/effect/turf_decal/stripes/line{dir = 5},/turf/open/floor/plasteel/white,/area/survivalpod)
"T" = (/obj/machinery/door/firedoor,/obj/machinery/door/airlock/research{name = "Research and Development Lab"; req_one_access_txt = "7;29"},/obj/effect/turf_decal/stripes/line{dir = 2},/obj/effect/turf_decal/stripes/line{dir = 1},/obj/structure/fans/tiny,/turf/open/floor/plasteel,/area/survivalpod)

(1,1,1) = {"
abcbcbdbe
fghijklmc
cnopqrstb
buovwxlyc
bzoABbCba
bDoAAEoFG
MHoIJJoKL
bNoOPQRSG
bbcbTbbbb
"}
